#####################################################################################################
S           #           #   #     #         #           #     #       #     #     #           #     #
########### # # ######### # # # ### # ####### ######### # ### # # ### # ### ##### # ##### ##### # # #
#         # # #         # #   #     # #   #   #       #     #   #   # # # #     #       # #   # # # #
# ### # ### ########### # ########### # # # ### ##### ####### ##### # # # ##### # ####### # # # # # #
# # # # #   #         # #     # #     # # # #   #     #     #     # # # #   #   # #     #   #   # # #
# # # ### ### ####### # ##### # # ##### # # # ### ##### ### ####### # # # # # ##### ### ####### # # #
# # #   # #   #     # #         #       #   # # #       # #   #     #   # #   #     # #   #   # # # #
# # ### # ### # ##### # ########### ######### # ######### ### # ######### ####### ### ### # # # # # #
# #   # #   # # #     #   #   #   # #         # #           # # #   #   # #       #     #   # # # # #
# # # # ### # # # ######### # # # ### ######### # ####### ### # # # # # # ##### ### ######### ### # #
#   # #       #             #   #     #                 #       # #   #         #                 # E
#####################################################################################################