#####################################################################################################
S       #     #       #           #     #       #     #         #       #       #     #   #         #
####### # ### # ####### ####### # # ### # ##### # # # # ######### # ### # # ##### # # # # # ####### #
#     # #   # #         #       # #   # #   #   # # #   #       # #   # # #     # # #   # #       # #
# ##### ### # # ##### ### ####### ##### ### # ### # # ### ##### # ### # # ##### # # ##### # ##### # #
#     # #   # # #   # #   #   # #     #   # #   # # # #   # #   # #   # # #   #   # #   # #   #   # #
# ### # # ### ### # ### ### # # ##### # # # ### # # ### ### # ### # ##### # ####### # # # ##### ### #
# #   #   # #   # #   # #   # #     # # # #   # # # #       #     # #   # #       # # #   #     #   #
# # ####### ### # ### # # ### ### ### ### ### # # # # ##### ####### # # # ### ##### # ##### ##### ###
# # #     #   #   # # # #   #   # #   #     # # # # # #   # #     #   # #   # #     # # #   #   #   #
# # # ### # # ##### # # # ##### # # ### ##### # # # # # # ### ### # ### ### # # ##### # # # # # ### #
# # # #   # #   #   # #   #   # # # #         #   #   # #   # #   # # #       # #     #   # # #   # #
### # # ### # # # ### # ### # # # # # ##### ########### ### # # ### # ######### # ######### # ##### #
#   # #   # # #   #   #   # #   # # # #   #       #     # #   #   #     #       # #         #   #   #
# # # ### # # ### # ### ### ##### # ### # ####### # ##### ####### # ##### ####### ### ####### # # ###
# # #   #   # # # # #   #   #     #     #   #     # #       #   # # #     #     #     #     # #   # #
# ##### ##### # # # ### # ### # # ######### # ##### ##### # ### # # # ##### ### ##### # ### ### ### #
#   #   #     #   #   # #   # # #   #     # #   #   #     #     # # #     #   # #     #   #   #     #
### # ### ##### ##### ### # # # ##### ### # ##### ### ######### # # ##### ### # ##### ### ### ##### #
#   # #   #   # #   #   # # # #   #   #   #       #       # #   # # #       # #     #   # # # #   # #
# ### # ### # # # # ### # # # ### # ### ################# # # ### # # ####### ##### ##### # # # # # #
# #   # # # #   # #     # # # #   #   #                 # #   #   # # #     #   # #       # #   # # #
# # ### # # ##### ####### # # # # # ########### ####### # ##### ### # # ### ### # ######### ##### ###
# #   # # # #     #       # # # # # #   #     #     # # #     #   # # #   #   #     #   #       #   #
# # ### # # # ##### ####### ### ### # # # ### # ### # # ##### ### ### ### ### ##### # # # ##### ### #
# # #   # # # #           #   # #   # # # # # # #   #         #   #     #   #     # # #   #       # #
# # # ### # # ############### # # ### # # # # ### # ########### ### ####### ### ### # ##### ####### #
# # # # #   #               # #   #   # # #   #   # #       #   # #       #   #   # # #     #       #
# # # # # ################# # ##### ### # # ### ### # ##### # ### # ##### ### ### # # # ### # ##### #
# # # #   # #   #         # #       #   # #   # #   #     #   #       #   # #   #   # #   # # #     #
# # # # ### # # # # ##### # # ####### ### ### # ######### ############# # # ### ######### # # ##### #
#   # #   # # # # # #   # # # #       #   #   # #   #   #     #   #     #     # #       # # #     # #
# ### ### # # # # # # # ### ### ####### # # ### # # # # ##### # # # ######### # ### # # # ####### # #
# #   # # #   #   #   # #   #   #   #   # #   #   #   #   #   # # #   #     # #   # # # # #     # # #
# # ### # ########### # # ### ##### # ### ### ##### ##### # ### # ### ### ### ### ### # # # ### # # #
# # #         #     # # # #     #   #   # #       # #     # #   #   #   #   # # # #   # # #   #   # #
# # ######### # ### ### # ##### # # ### # ####### ### ##### # # ### ### ### # # # # ### # ### # #####
# # #       #   # #   # #   #   # #   # # #     # #   #   # # # #   #   #   # # # # # # #   # # #   #
### # ##### ##### ### # ### # ### ##### # # ### # # ### # # ### # ### ### ### # # # # # ### # ### # #
#   # #   # #   #         # # #   #     #   #   # # #   # #     # # #   # #     # # # #     # #   # #
# ### # ### # # # ######### # # ### ######### ### # # ### ####### # # # # # ##### # # ##### # # ### #
#     #   #   # #   #   #   # # #   #       # # # # #   # #     # # # # #   #     # #     # #   #   #
# ##### # ##### # ### # # ### # # ####### ### # # # # ### # # # # # # # ##### ##### # ##### ##### # #
#     # #   #   # #   # #     # # #       #   #   # # #   # # # # #   # #     # #   #       #     # #
##### ### # # ##### ### ####### # # # # ### ### ### # # ### # # # ##### # ##### # # ### ##### #######
#   #     # # #     #     #   #   # # # #   #       # #     # # # #     #   #   # #   #     #       #
### ####### # # ##### ### # # # ### # ### ### ####### ####### # # # ### ### # # # ### ####### ##### #
#     #   # #   #     #     # # #   #   #   # #   #   #       # # #   # #   # #   #   #     #   # # #
# ### # # # ##### # ######### # # ##### ### ### # # ### ####### # ### ### ######### # # ### ### # # #
# # # # #     #   # #   #     # # #       #     # # # # #   #   # #   #   #       # # # # #   #   # #
# # # # ####### # ### # ####### # # ############# # # # # # # ### # # # ### ##### # # # # ### ##### #
# #   # # #     # #   #   #     # #   #     #   # # # # # #     # # # #   #   #     # # #   # #     #
# ##### # # ##### # ##### # ####### # # # ### # # # # # ######### # ##### ### ####### # # ### # #####
# #   #   # # #   # #   # # #     # # # #     # # # # #       #   #     #   #   #   # # #   # # #   #
# # # ### # # # ### # ### # # ### ### # ####### # # # ####### # ### # ##### ### # # ### # # # # # # #
# # # #   # #     # # #   #   # #   # #   # #   # #     #     # #   #           # #     # # # #   # #
# # # # ### ####### # # ####### ### # ### # # ### ### ### ##### # ############# # ####### # # # ### #
# # # #   #       #   #   #   #   # #   #   #   #     #   #     #     #   #   # # #   #   # # #   # #
# # # ### ####### ### ### # # # # # # ##### ### ####### ### ######### # # # # ### # # ##### # ##### #
# # #   # #     #   #   # # # # #   #       #   #     #   # #   #     # #   # #   # #   #   # #   # #
# # ### # ### # ### ### # # # # ########### # ### # ##### # # # # ##### ##### # ### ### # ### # # # #
#   # # #     # # # #   #   # # #         # # #   #     #   # # #   #   #   # #   # #   # #     #   #
# ### # # ##### # # # ####### # ##### ### # # # ####### ##### # ### # ### # # # # # # ### # ####### #
#     #   #   #   # #     # # #       # # # # # #     #   #   #   # # #   # # # #   # #   # #     # #
##### ##### # ##### ##### # # ######### # # # # # ####### # ### ### # # # ### # ##### ### # # ### ###
#   # #     #       #   #   #         #   # # # #   #   # #   # #   # # # #   # #     #   # # # #   #
# # # # ############# # ### # ##### ### ##### # # # # # # ### # # ### # # # ##### ##### ### # # ### #
# # # # #   #         #     #   # # #   #     # # # # # #     #   #   # #         #         # #   # #
# # # # # # # ########### ##### # # # ##### # # ### # # ########### ### ##### ############### # # # #
# #   #   # #   #       # #     #   #   #   # #   #   #     #       #   #   # #   #         # # # # #
# ######### ### # ##### ### ##### ##### # ####### ### ### ### ##### ##### # ### # # ####### # ### # #
#   #         # # #         #   #   #   #       #   #   #   # #   # #   # # #   #   #   #   # #   # #
# ### ####### # # ######### # # ### # ### ##### ### ##### # # # # # # # # # # ######### # ### # # # #
# #   #   #   # #     #   # # #   # # #   #   #   #     # # # # #   # #   #   #   #     #   # # # # #
# # ### ### ### ##### # ### # ### ### ### ### # ####### ### # ##### # ######### # # # ##### # # # # #
# # #   #   #   #   # # #   #   #   #   # #   #   #   # #   #     # # #       # #   #     # #   # # #
# # ### # ### ### ### # # ##### ### ### # # ##### # # # # ####### ### # # ##### ######### # ##### # #
# #   #   #   # #   # #   #     #   # # #   #   #   # # #       #     # #     #   #     # #       # #
##### ##### ### # # # ### # ##### # # # ##### # # ### # ### # ######### ##### # ### ### # ######### #
#     #   # #     # #   # #   #   #   #       # # # # #   # #           #   #   #   # #   #   #   # #
# ##### # # # ##### ### # ### # ############### # # # ### # ######### ### # ### # ### ### # # # # # #
#       # # #   #   #   # # # #             #   #   # #   # # #     #   # #   # # #   #   # # # #   #
######### # ### # # # ### # # ########### ### ##### # # ### # # ### ##### ### ### # ### ##### # ### #
#         # #   # # # # #   #   #     #   #   #   # #     #   # # # #     # # #   #   # #   # # #   #
# ######### # ### ### # ### ### ##### # # # ### # ####### ### # # # # ##### # # ##### # # # # # #####
# #     #   # #   #   #     # #       # # #     # #   # # #   # #     #     #   #     # # #   #     #
# # ### # ##### # # ####### # ####### # # ####### # # # # # ### # ##### # ####### ##### # ######### #
#   #   #       # #   #   #   #   #   # # #     #   # #   #   # # #   # # #       #       #         #
# ### ########### ### # # ### ### # ### ### # ####### # ##### # # # # ### # ##### # ####### ### #####
# #   #   #     # #   # # # #     #   #     #   #   # #     # # # # #   #   #   #   # #   # #   #   #
### ### # # # # # # ### # # ##### ### ######### # # # ##### ### # # ### ##### # # ### # # # # ### # #
#   #   #   # # # #   # # #         # # #     #   # #     #     # # # #       # # #   # #   #   # # #
# ### ####### # # ### # # ########### # # ### ##### ##### ######### # ######### # ### # ######### # #
# #   #     # # # # # # #           # #   #   #       #   #   #   # #     #   # #   # #       #   # #
# # ##### ### # # # # # ########### # ##### # # ##### # ### # # # # # # ### # # ### # ####### # ### #
# #       #   # # # # # #   #   #   #       # # #     #     # # # # # # #   # #   #         #   #   #
# ### ##### ##### # # # # # ### # ######### ### ############# # # # # # # ### ### # ############# # #
#   # #     #   # # # #   #   # #   #     # #   #     #     #   #   # #   # # #   # #   #       # # #
# # # # ##### # # # # ####### # ### # # ### # ### ### # # ########### ##### # # ##### # # ##### # # #
# #   #       #     #             #   #     #       #   #                   #         #   #       # E
#####################################################################################################