###########################
  # #               #     #
# # # ######### ##### ### #
# #   # #       #     #   #
# # ### # ####### ##### ###
# #     # #       #   #   #
# ##### # # ####### # ### #
#   #   #   #     # #   # #
### # ##### ### # # ##### #
# # # #   #   # #   #     #
# # # # # ### # ##### ### #
# # # # #   #   #     # # #
# # # # ### ##### ##### # #
# # # # #       # #   # # #
# # ### ####### # # # # # #
# #   #   #   #   # #   # #
# ### # # # # ##### ##### #
#   # # #   # #   #     # #
# # # ####### # # # ### # #
# # #     #   # # #   #   #
# # ##### # ### # ### #####
# # #   # #   # # #   #   #
# # # # # # # # # # ### # #
# # # #   # # # #   #   # #
# ### ##### # # ##### ### #
#   #   # # # #       #   #
# # ### # # # ######### ###
# #   # # # #   #   #     #
# # ### # # ### ### # #####
# # #   #     #   #   #   #
# # # ######### # ##### # #
# # #         # # #   # # #
# # ######### # # # # # # #
# # #       # # # # #   # #
# # # ### # # ### # ##### #
# #   #   # #   #     #   #
# ##### ### ### ##### # # #
#     # #   #   #   # # # #
### ### # ### ### # ### # #
#   #   # #   #   #   # # #
# ### ### # ##### ### # ###
#   # #   # #     #   #   #
# ### ##### # ##### ### # #
# #   #   #   #   # # # # #
# # ### # ##### ### # # # #
# # #   #           #   # #
### # ################### #
#   #   #                 #
# ##### # ############### #
#     # #   #           # #
# ### # ### # ######### # #
#   # #   # #     # #   # #
### # ### # ##### # # ### #
# # #   #   #       # #   #
# # ### ##### ####### # ###
#   # #           #   # # #
# ### ############# # # # #
# #       #   #   # # #   #
# ##### # ### # # # # ### #
#       #     # #   # #   #
########### ### # ##### ###
#       # # #   # #     # #
# ### # # # # ##### ##### #
#   # # # # # #     #     #
### # # # # # # ##### ### #
#   # #   # #   #   # #   #
# ### ### # ####### # # # #
#   #   # #       #   # # #
####### # ####### ##### ###
#     # # #     #     #   #
# ### # ### ### ##### ### #
#   #   #     #     #     #
# # ##### ####### # ##### #
# #   #   #     # # #   # #
##### # ### ### ### # # # #
#     # #   #       # # # #
# ##### # ########### # # #
#   #   #           # #   #
# # # ############# # #####
# # #   #       #   #     #
### ### ##### # # # ##### #
#     #       # # #     # #
# ### ######### # ### ### #
#   # #     #   #   # #   #
### # # # ### ##### # # ###
#   # # #     #   # # # # #
# # ### ######### # ### # #
# # #   #   #     #   #   #
# # # ### # ### ##### ### #
# # #     # #   #       # #
# ######### # ### ####### #
#       #   #   #       # #
# # ### # ##### ####### # #
# # #   #         #   # # #
# # ### ####### ### # # # #
# #   #     #   #   #   # #
# ### ####### ### ####### #
#   #       # # # #   #   #
### ####### # # # # # # ###
#         #     #   #      
###########################